111111111111111111111111111111111111111111111111
1PC00000000000000000000000000000000000000000E011
111111111111111111111111111111111111111111111111