1111111111
10000C0001
100P000001
1C00001CC1
10100C1E01
1111111111