11111111
1      1
1   1111
1    101
11111101
10000E01
11111111

while (charmap[i])

{
    while(charmap[i][j])

}


111111111111111111111111111111111111111111111111
1PC00000000000000000000000000000000000000000E011
111111111111111111111111111111111111111111111111