11111111111
1P100C1C0E1
10001C00101
10000000001
10C0000C001
10000000001
11111111111