111111
1P1CE1
111111


char *buf = 111111\n10PCE1\n111111\0

char **map

map[0] = "111111"
map[1] = "10PCE1"
map[2] = "111111"

if map[i][j] == '0'

if map[i][j] == '1'

if map[i][j] == 'P'

if map[i][j] == 'C'

if map[i][j] == 'E'