11111111111
1P100010001
11101010101
100C11001E1
11111111111