111111
10PCE1
111111


char *buf = 111111\n10PCE1\n111111\0

char **map

map[0] = "111111"
map[1] = "10PCE1"
map[2] = "111111"

if map[i][j] == '0'

if map[i][j] == '1'

if map[i][j] == 'P'

if map[i][j] == 'C'

if map[i][j] == 'E'


11111111111
100P0C00001
1110100C011
1000CC00EC1
11111111111


11111111111
10000000001
100P0C00001
1000000E001
11111111111


11111111111
1 E1      1
1 1P      1
1 1       1
11111111111


11111111111
10E1      1
101    P  1
101       1
11111111111


11111111111
1 E       1
1 1P  11  1
1 1    C  1
11111111111


11111111111
10000000001
10000000001
100P0C00001
1000000E001
11111111111


11111111111
100000EC001
100P0C10001
10000100001
11111111111

11111111111
100000EC001
100P0C00001
10000100001
11111111111

11111111111
1P100C1C0E1
10001C00101
10000000001
10C0000C001
10000000001
11111111111