11111111111
1P1P0010001
11101010101
100C11401E1
11111111111