11111111111
10000001001
100P0C11001
1000010E001
11111111111